//MAP CONVERTED BY dmm2tgm.py THIS HEADER COMMENT PREVENTS RECONVERSION, DO NOT REMOVE
"a" = (
/obj/structure/foamedmetal,
/obj/structure/window/spawner/directional/west,
/turf/open/floor/holofloor/asteroid,
/area/space)
"b" = (
/obj/structure/foamedmetal,
/obj/structure/window/spawner/directional/east,
/turf/open/floor/holofloor/asteroid,
/area/space)
"e" = (
/obj/structure/table,
/obj/machinery/recharger,
/turf/open/floor/holofloor/asteroid,
/area/space)
"k" = (
/obj/structure/foamedmetal,
/turf,
/area/space)
"l" = (
/turf/open/floor/holofloor/asteroid,
/area/template_noop)
"m" = (
/turf/open/floor/holofloor/asteroid,
/area/space)
"n" = (
/obj/structure/table,
/obj/item/gun/energy/laser,
/turf/open/floor/holofloor/asteroid,
/area/space)
"t" = (
/obj/structure/foamedmetal,
/turf/open/floor/holofloor/asteroid,
/area/space)
"u" = (
/obj/structure/table,
/obj/machinery/recharger,
/turf/open/floor/holofloor/asteroid,
/area/template_noop)
"v" = (
/obj/structure/table,
/obj/item/stack/medical/ointment{
	heal_burn = 10
	},
/turf/open/floor/holofloor/asteroid,
/area/space)
"x" = (
/obj/structure/foamedmetal,
/obj/structure/window/spawner/directional/east,
/obj/structure/bookcase/random/fiction,
/turf/open/floor/holofloor/asteroid,
/area/space)
"H" = (
/turf/open/space/basic,
/area/space)
"I" = (
/obj/structure/table,
/obj/item/gun/energy/laser,
/turf/open/floor/holofloor/asteroid,
/area/template_noop)
"J" = (
/obj/structure/table,
/obj/item/stack/medical/bruise_pack{
	heal_brute = 10
	},
/obj/item/soap,
/turf/open/floor/holofloor/asteroid,
/area/space)

(1,1,1) = {"
a
a
a
a
a
a
a
a
a
a
"}
(2,1,1) = {"
b
x
b
b
b
b
b
b
b
b
"}
(3,1,1) = {"
k
t
k
t
t
t
t
t
t
t
"}
(4,1,1) = {"
m
m
m
m
m
m
m
m
m
m
"}
(5,1,1) = {"
m
m
m
H
m
m
m
m
m
m
"}
(6,1,1) = {"
m
l
m
m
m
m
m
m
m
m
"}
(7,1,1) = {"
m
l
l
l
l
m
m
m
m
m
"}
(8,1,1) = {"
m
l
l
l
l
m
m
m
m
m
"}
(9,1,1) = {"
v
u
I
l
I
I
m
n
e
J
"}
